NO ./textures/test.xpm
WE ./textures/test.xpm
SO ./textures/test.xpm
EA ./textures/test.xpm

C  235,241,245
F  143,     255,242


11111111111111111111111111111111111
10000000000000000000000000000000001
10000000000000000000000000S00000001
10000000000000000000000000000000001
11111111111111111111111000000000001
11111111111111111111111000000000001
11111111111111111111111111111110011
11111111111111111111111111111110011
                            1110011
                            1110011
                            1110011
                            1110011
                            1110011
                            1110011
                            1110011
                            1110011
                            1110011
                            1110011
                            1110011
                            1110011
                            1110011
                            1110011
                            1111111