NO ./textures/test.xpm
WE ./textures/test.xpm
SO ./textures/test.xpm
EA ./textures/test.xpm

F 1,15,30
C 150,150,245


11111111111111
10000000000001
11111111111111111111111111111111
10000000000000000000000000000001
10000000001111111111101111011111
10001111111000000000001111100011
10000000001000000000001111111101
10001111111000000000000001100001
10010000000000000000000001100001
10100000000000000000000001100001
11000000001100000000000000000001
10000000001100000000000001100001
100000N0001000000000000001100001
11111111111111111111111111111111


