NO ./textures/test.xpm
WE ./textures/test.xpm
SO ./textures/test.xpm
EA ./textures/test.xpm

C  235,241,245
F  143,     255,242


11111111111111
10000000000001
11111111111111111111111111111111
10000000000000000000000000000001
10000000001111111111101111011111
10001111111000000000001111100011
10000000001000000000001111111101
1000111111100000000000000110000N
10010000000000000000000001100001
10100000000000000000000001100001
11000000001100000000000000000001
10000000001100000000000001100001
10000000001000000000000001100001
11111111111111111111111111111111
10000000001000000000000001100001
11111111111111111111111111111111
