NO ./textures/test.xpm
WE ./textures/test.xpm
SO ./textures/test.xpm
EA ./textures/test.xpm

C  235,241,245
F  143,     255,242


          1111111111111
          1000000000111
          1011000001111
         110010000000011111111111111111111111111111111111111111111111111111111
11111111101100000111000000000000000000000N000000000000000000000000000000000011
100000000011000001111101111111111111111111111111111111111111111111111111111111
111100000000000111000000100011
110000000000001110101001000111
110000001101010111000000000001
100000000000000011000000100011
100000000000000011010100100011
110000011101010111110111100011
111111111111111111111111111111