NO ./textures/test.xpm
WE ./textures/test.xpm
SO ./textures/test.xpm
EA ./textures/test.xpm

C  235,241,245
F  143,     255,242


1111111111111111111111111
1000000000110000000000001
1011000001110000000000001
100100000000000000000000011111111
111111111011000001110000000000001
100000000011000001111101111111111
1111011111111101110000N010001
1111111111111111111111111111