NO ./textures/east.ppm
WE ./textures/souh.ppm
SO ./textures/east.ppm
EA ./textures/west.ppm

F 1,15,30
C 150,150,245


11111111111111
10000000000001
11111111111111111111111111111111
10000000000000000000000000000001
10000000001111111111101111011111
1000111111100000000000111110001
10000000001000000000001111111101
10001111111000000000000001100001
10010000000000000000000001100001
10100000000000N00000000001100001
1000000001100000000000000001111
1000000000110000000000000111
1000000000100000000000001111111
11111111111111111111111111111111


