NO ./textures/test.xpm
EA ./textures/test.xpm
WE ./textures/test.xpm
SO ./textures/test.xpm

F  163,207,217
C  242,194,194

1111111111111111111111111
1000000000110000000000001
1011000001110000000000001
100100000000000000000000111111111
111111111011000001110000000000001
100000000011000001111101111111111
11110111111111011100000010001
1111111111111011101010010001
1100000011010101110000000S001
10000000000000001100000010001
10000000000000001101010010001
11000001110101011111011110001
1111011111100011011110100011
111111111111111111111111111