NO ./textures/test.xpm
WE ./textures/test.xpm
SO ./textures/test.xpm
EA ./textures/test.xpm

C  235,241,245
F  143,     255,242


1111111111111111111111111
1000000000110000000000001
1011000001110000000000001
1001000000000000000000000111111111111111111111111111111111111111111111111111111111
1111111110110000011100000000000000000000000000000000000000000000000000000000000001
1000000000110000011111011111111111111111111111111111111111111111111111111111111111
11110111111111011100000010001
1111111111111011101010010001111111111111111111111111111111111111111111111111
110000001101010111000N000000000000000000000000000000000000000000000000000001
1000000000000000110000001000111111111111111111111111111111111111111111111111
10000000000000001101010010001
11000001110101011111011110001
1111011111100011011110100011
111111111111111111111111111
111111111111111111111111111
111111111111111111111111111
111111111111111111111111111