NO ./includes/cub3d.h
SO ./includes/cub3d.h
WE ./includes/cub3d.h
EA ./includes/cub3d.h
F 150,255,255
C 255,0,0
1111111111111111111111111
1000000000110000000000001
1011000001110000000000001
100100000000000000000000111111111
111111111011000001110000000000001
100000000011000001110111111111111
11110111111111011100000010001
1111011111111101110101001N001
11000000110101011100000000001
10000000000000001100000010001
10000000000000001101010010001
1100000111010101111101111000111
11110111 1110001 101111010001
11111111 1111111 111111111111